# #######################
#   #           #        
# ### ####### ### ### # #
#     #     #     # # # #
# ####### # ####### # # #
#   #     # #       # # #
### ### ### ### ##### # #
#       #       #   # # #
################# # # ###
#     #           # #   #
# ### # ########### # # #
#   #   #       #   # # #
### ######### ### ##### #
# #   #       #   #     #
# ### # ##### # ### ### #
#   #   #     # #   #   #
# # ##### ##### # #######
# #   # # #     #       #
### # # # ####### ##### #
#   #   # #     #   #   #
# ####### ### # ##### # #
#       # #   #       # #
# ##### # # ########### #
#     #     #           #
#########################
